1111111111111111111
10C0000000C0000C0C1
1000111111111110C01
1001100000000011C01
10001C1111110011001
10C01C1C0100001C001
10C01C1C0C01001C001
11C01C1C0C01001C001
1C101C1C1P01001C011
1CC00C0C0C010011001
10001C1C0C0100100E1
1111111111111111111
