111111111111111111111
1P1010001000100010001
101010101010101010101
101010101010101010101
101000101010101010101
1C001C10CC100C10C01E1
111111111111111111111
