11111111111111111111111111111111
10000000000000000000000000000001
10111111111111111111111111111101
1010C000000000000000000000000101
10101111111111111111011111110101
101010C0000000000000000000000101
10101011111111111111101111110101
101010100000C0000000000000000101
10101010111111111111011111110101
101010101000000000000C0000000101
10101010101010101010100000000001
10101010101010101010101111110101
1010101010101010101010100000P101
1000000000000000000000000CCCCCE1
11111111111111111111111111111111


