1111111111111111111
100E0S0010000000001
1110011110P0C00S011
1000000000000000111
100C0S000000C000001
1000001101111100011
10000010C00S0100001
1111111111111111111
