1111111111111111111
10C0000000C0000C0C1
1000111111111110C01
10011000S00S0011C01
1S00101111110011S01
10C0101C010S0010001
10C01C1C0C010010001
11C0101C0C01001C001
1C101C1C1P010010001
10C0000C0C010011001
100S1C1C0C0100100E1
1111111111111111111
